999,999,168,999,999,999,999,999,999,999,999,999,999,999,999,999,999,999,999,999,999,999,166,999,165,999,164,999,999,999
999,172,167,999,999,999,999,999,999,999,999,999,999,999,999,999,999,170,999,999,999,999,999,999,999,999,999,999,999,999
999,169,999,999,999,999,999,999,999,999,999,999,999,999,999,999,999,999,999,999,164,999,999,999,999,999,999,165,999,999
999,999,999,999,999,999,172,999,999,999,999,999,999,999,999,176,999,999,169,999,999,166,999,999,999,999,999,999,167,999
999,999,999,999,999,999,999,173,999,999,999,999,999,999,999,999,999,999,999,999,999,999,999,999,999,999,999,999,999,999
999,999,999,999,999,999,999,999,166,999,999,999,999,999,999,999,999,999,999,999,999,999,999,999,999,176,999,999,999,999
999,999,999,999,999,999,999,999,176,999,176,999,999,174,999,999,999,167,999,999,999,999,999,999,999,999,999,999,999,999
999,999,999,999,999,999,999,999,999,169,999,999,174,999,999,999,999,999,999,999,999,999,999,999,999,999,999,999,999,174
168,999,999,999,999,999,999,999,173,999,999,999,999,172,999,999,999,999,999,999,999,999,999,999,999,174,999,999,999,999
999,999,999,176,999,999,999,999,176,999,999,999,999,999,999,176,999,999,176,999,999,176,999,999,999,999,999,999,999,999
999,999,999,165,999,174,999,999,999,999,176,999,999,999,999,999,999,999,999,999,999,999,999,999,999,999,999,999,999,999
999,999,999,999,999,999,999,999,999,999,999,999,999,999,999,999,999,999,999,999,999,999,172,999,999,999,176,999,999,999
999,999,999,999,999,999,999,999,999,999,999,999,999,999,999,173,173,999,999,999,999,999,999,999,999,999,999,999,999,167
999,999,999,999,999,999,173,999,176,999,999,999,999,999,999,999,999,999,999,999,999,999,999,999,999,999,999,999,168,999
171,999,999,999,999,999,173,999,999,999,999,999,176,999,999,999,999,999,999,999,176,999,999,999,999,999,999,999,167,167
170,168,999,999,999,173,999,999,999,999,171,999,999,169,999,999,999,999,999,171,999,999,999,999,999,999,167,169,999,170
