1,  1,  1,  5,  5,  5,  1,  1,  1,  1,  1,  1,  1,  1,  1,  1,  1,  1, 78, 56,  3,  3,  3,109,  2, 99,123,  3,  3,  7
1,  1,  5,  5,  1,  1,  1,  1,  1,  1,  1,  1,  1,  1,  1,  1,  1,  1,  1, 78, 79, 79, 56,121,122,123, 55, 79, 79, 56
1,  1,  5,  1,128,153,153,153,153,153,153,153,153,153,129,  1,  1,  1,  1,  1,  1,  1, 66,  3, 55, 79, 80,  1,  1, 78
1,  1,  1,  1,141,116,  6,  6,  6,  6,  2,  6,116,  2,140,  1,  5,  5,  5,  5,  1,  1, 78, 79, 80,  1,  1,  1,  1,  1
5,  5,  1,  1,141,  2,  2,  6,  2,  2,  6,  6,  2,  2,140,  1,  1,  1,  1,  5,  5,  1,  1,  1,  1,  1,  1,  5,  5,  1
5,  1,  1,  1,141,  6,  2,125,126,126,126,127,  2,  6,140,  1,  5,  1,  1,  1,  5,  1,  1,  1,  1,  1,  1,  1,  1,  1
5,  5,  1,  1,141,  6,  6,140,  1,  1,  1,141,  2,  6,140,  1,  5,  5,  1,  1,  1,  1,128,153,153,153,153,153,153,153
1,  5,  5,  1,141,  2,  6,140,  5,  5,  1,141,  6,  6,140,  1,  1,  5,  5,  5,  1,  1,141,116,  2,  2,  6,  6,  2,159
1,  1,  1,  1,141,  2,  2,140,  1,  5,  1,141,  6,  2,140,  1,  1,  1,  1,  1,  1,  1,141,  6,  6,  6,  2,  6,  6,  2
1,  1,  1,  1,141,  6,  2,140,  1,  5,  1,141,  6,  6,140,  1,  1,  1,  1,  1,  1,  1,141,  2,  6,125,126,126,126,126
1,  1,  5,  1,141,  2,  6,140,  1,  5,  1,141,  2,  2,152,153,153,153,153,153,153,153,154,  2,  2,140,  1,  1,  1,  1
1,  1,  5,  5,141,  2,  6,140,  5,  1,  1,141,116,  2,  6,  6,  6,  2,  2,  6,  6,  6,  2,116,  2,140,  1,  1,  1,  1
1,  1,  5,  5,141,  6,  2,140,  5,  5,  1,141,  6,  2,  2,  2,  6,  6,  6,  2,  6,  2,  2,  6,  6,140,  1,  1,  1,  1
1,  5,  5,  1,141,  2,  2,140,  1,  5,  5,142,126,126,126,126,126,126,126,126,126,126,126,126,126,143,  1,  1,  1,  1
1,  5,  1,  1,141,  6,  2,140,  1,  5,  5,  1,  1,  1,  5,  1,  1,  1,  1,  1,  1,  1,  5,  5,  1,  1,  1,  1,  1,  1
1,  1,  1,  1,141,116,  2,140,  1,  5,  5,  1,  1,  5,  5,  5,  5,  5,  5,  1,  1,  5,  5,  1,  1,  1,  1,  1,  1,  1
